### ###
#     #
# #####
#   # #
# # # #
# #   #
### ###
